##########################
#S             # #      ##
# # # # # ### ###        #
# # #   #     # #       ##
#                        #
# #   # #               ##
# ####### # ### ######E ##
##########################
